########################################
#                  #++++#              #
#                  #    #              #
#                  #    #              #
#                  #    #              #
#                  #    #              #
#    ###############    ##########     #
#    #                           #     #
#    #                           #     #
#    #                           #     #
#    #                           #     #
#    #                           #     #
#    #                           #     #
#    #                           #     #
#    #                           #     #
#    #                           #     #
#    #                           #     #
#    #                           #     #
#    #            H              #     #
#    #                           #     #
#    #                           #     #
#    #############################     #
#                                      #
#                                      #
#                                      #
#                                      #
#                                      #
#                                      #
#                                      #
########################################